NO assets/sprites/nowall.xpm
SO assets/sprites/sowall.xpm
EA assets/sprites/eawall.xpm
WE assets/sprites/wewall.xpm

F 0,0,0
C 189,183,107

11111111111
10000000001
10111111101
10111111101
10111111101
10111111101
10000000001
11111011111
11111011111        
111110111111
100000000001
100100000001
1001000N0001
10010000000111
10000000000001
11111111111111
