C 122,121,120
F 77,78,79

NO assets/sprites/nowall.xpm
SO assets/sprites/sowall.xpm
EA assets/sprites/eawall.xpm
WE assets/sprites/wewall.xpm

11111111111111
10000000000001
1000000010000111
1000000100000001
10N0001000000111
10000100000001
11111111111111
