F 0         ,0,   0
              C 189,183,                          107




NO assets/sprites/nowall.xpm




SO assets/sprites/sowall.xpm
   WE assets/sprites/wewall.xpm

EA assets/sprites/eawall.xpm            

        

111111111111111111111111111
100000000000000000000000001
10S000000000000000000000001
100011111111111111111111111
10001
10001
11001               
10001
10001
10001
10001
10001
11111           
