WE assets/sprites/wewall.xpm
NO assets/sprites/nowall.xpm
EA assets/sprites/eawall.xpm
SO assets/sprites/sowall.xpm

F 7,216,36
C 12,101,19
      
   111111111111
   100100000001
   100100000001
1111000000S0001
100000100000001
100000000000011
111111111111111
