NO assets/sprites/nowall.xpm
SO assets/sprites/sowall.xpm
EA assets/sprites/eawall.xpm
WE assets/sprites/wewall.xpm

F 53,25,
C 100,100,100

11111
10001
10S01
11111
