NO assets/sprites/nowall.xpm
SO assets/sprites/sowall.xpm
EA assets/sprites/eawall.xpm
WE assets/sprites/wewall.xpm

F 0,0,0
C 1,1,1

1111
1001
10S1
1001
1001

1101
1001
1001
1111
