F 8,0,-10
C 255,225,255

NO assets/sprites/nowall.xpm
SO assets/sprites/sowall.xpm
EA assets/sprites/eawall.xpm
WE assets/sprites/wewall.xpm

11111
10001
10S01
11111

