NO assets/sprites/nowall.xpm
SO assets/sprites/sowall.xpm
EA assets/sprites/eawall.xpm
WE assets/sprites/wewall.xpm

F 218,216,215
C 208,206,205

111111111111
111111111111
111111111111
111111111111
10000000001
1       0001
100000000011
10S000000001
111111111111
111111111111
111111111111
