NO assets/sprites/nowall.xpm
SO assets/sprites/sowall.xpm
EA assets/sprites/eawall.xpm
WE assets/sprites/wewall.xpm

11111111
10000001
10S00001
10000001
11111111

F 12,12,2
C 3,3,33


