NO assets/sprites/nowall.xpm
SO assets/sprites/sowall.xpm
EA assets/sprites/eawall.xpm
WE assets/sprites/wewall.xpm

F 9,9,9
C 16,16,16

11111111
10000001
10N000N1
10000001
11111111
