
SO assets/sprites/sowall.xpm
EA assets/sprites/eawall.xpm

F 13,15,17
C 22,222,12

11111111
10000001
10000011
100N1111
10000001
10000001
11000001
10000001
11111111
