NO assets/sprites/nowall.xpm
SO assets/sprites/sowall.xpm
EA assets/sprites/eawall.xpm
SO assets/sprites/sowall.xpm
SO assets/sprites/sowall.xpm

F 63,63,63
C 56,56,56

11111111
10000001
10S00001
10000001
11111111
