PA assets/sprites/nowall.xpm
SO assets/sprites/sowall.xpm
EA assets/sprites/eawall.xpm
WE assets/sprites/wewall.xpm

C 1,1,1
F 1,1,1

11111
10001
10S01
11111
