NO assets/sprites/nowall.xpm
SO assets/sprites/sowall.xpm
EA assets/sprites/eawall.xpm
WE assets/sprites/wewall.xpm

F 1,1,1
C 0,0,0

1111  11
1000  11
10N0  11
1000  11
1111  11
